1111111111
1000000001
1P01110111
10000C0101
10110000E1
1111111111